1662233300
2622213000
2622216600
3614200000
6641434330
6614433000
6166511000
6133344140
5556511333
5666644443